title	group
Marleen Huysman	KIN
Bart van den Hooff	KIN
Hans Berends	KIN
Frans Feldberg	KIN
Maura Soekijad	KIN
Philipp Tuertscher	KIN
Tibert Verhagen	KIN
Marlous Agterberg	KIN
Fleur Deken	KIN
Rosalinde Klein Woolthuis	KIN
Marijn Plomp	KIN
Inge van de Weerd	KIN
Anastasia Sergeeva	KIN
Tommaso Caselli	CLTL
Minhs virtual lab	CLTL
Ben Peperkamp	L&S
Petra Bos	CIW
Nel de Jong	CIW
Martijn Kleppe	CIW
Marca Schasfoort	CIW
Wouter van Atteveldt	CW
Dr. Jos Bartels	CW
Dr. Camiel J. Beukeboom	CW
Chei J. Billedo, MSc	CW
Nicoleta Balau, MSc	CW
Dr. Christian Burgers	CW
Prof. Dr. Brad J. Bushman	CW
Dr. Allison L. Eden	CW
Anouk den Hamer, MSc	CW
Dr. Tilo Hartmann	CW
Britt Hoeksema, MSc	CW
Dr. Anita M. J. van Hoof	CW
Dr. B.K. Johnson	CW
Prof. dr. Peter Kerkhof	CW
Prof. dr. Jan Kleinnijenhuis	CW
Celine Klemm, MSc	CW
Prof.dr. Elly A. Konijn	CW
Dr. Guido M. van Koningsbruggen	CW
Dr. Andre P.M. Krouwel	CW
Dr. Dirk Oegema	CW
Dr. Jaap W. Ouwerkerk	CW
Plaisier, X.S.	CW
Drs. Fam te Poel	CW
Dr. A.M. van Prooijen	CW
Dr. Giulia Ranzini	CW
Drs. D.J. Schutten	CW
Drs. Marloes L.C. Spekman	CW
Dr. Martin Tanis	CW
Dr. Jolanda Veldhuis	CW
Dr. Ivar E. Vermeulen	CW
Kasper Welbers, MSc	CW
Dr. Coen Wirtz	CW
dr. J.W. Dyk	ETCBC
Dr O. Glanz	ETCBC
Brenda Kronemeijer-Heyink	ETCBC
prof. dr. W.T. Peursen	ETCBC
Peter Boncz	CS
Frank van Harmelen	CS
Rinke Hoekstra	CS
Guus Schreiber	CS
Lora Aroyo Homepage	CS
Tobias Kuhn	CS
Plus Ultra	CS
Antoine Isaac 	CS
Chris Welty	CS
Bianca Beersma	FSW
Website Kees Boersma	FSW
Dr. W.A.M Borst (Irma)	FSW
Greetje Corporaal	FSW
Dr. C. van Dyck	FSW
Dr. A.L. van den Ende	FSW
Dr.ir. M. van der Gaag	FSW
L. Glimmerveen, MSc	FSW
Prof.dr. P. Groenewegen	FSW
Dr. I.R. Hellsten	FSW
Dr. F.H. Kamsteeg	FSW
Prof.dr.ing. A.H. van Marrewijk	FSW
Dr. S. Merkus	FSW
Dr. C. Moser	FSW
Prof. dr. H.L.G.R. Nies (Henk)	FSW
Dr. C.H. Roessingh	FSW
Dr. I.H.J. Sabelis	FSW
Prof.dr. P.C. van der Sijde	FSW
Dr. M.J. Spierenburg	FSW
Dr. Yvette Taminiau	FSW
DelArte	FSW
P.S.C. van Teunenbroek MSc	FSW
Prof.dr. M. Veenswijk	FSW
Dr. Michiel Verver	FSW
Dr. I. Wakkee	FSW
T.A.H. Willems (Thijs), MSc	FSW
Dr. J.J. Wolbers	FSW
Dr. S.B. Ybema (Sierk)	FSW
Department of Philosophy	AXIOM
dr. A.W.F. (Alexander) Boer	LEIBNIZ
